Higher up placements have higher prio
Longer names or names with titles should go higher
If a name has A + B + C and a higher placement name has A + B the higher up name will take prio
{{A}}}, {{B}} etc also take placement into consideration

// OG P5 //
雨宮蓮=Ren Amamiya
坂本龍司=Ryuji Sakamoto
摩爾 加納=Morgana
摩爾加納=Morgana
高卷杏=Ann Takamaki
喜多川祐介=Yusuke Kitagawa
新島真=Makoto Niijima
佐倉雙葉=Futaba Sakura
奧村春=Haru Okumura
明智吾郎=Goro Akechi
芳澤霞=Kasumi Yoshizawa
芳澤堇=Sumire Yoshizawa

// MAIN //
伊格爾=Igor
梅洛普=Merope
瑪奇姆=Marthym
路菲爾=Ruferu
新井素羽·夏日=Summer Motoha Arai
新井 素羽=Motoha Arai
新井素羽=Motoha Arai
新井=Arai
素羽=Motoha
加納 駿=Shun Kanou
加納駿=Shun Kanou
加納=Kanou
小駿=Shun
多禰村理子=Riko Tanemura
多禰村=Tanemura
理子學姐=Riko-senpai
理子=Riko
野毛朋子·夏日=Summer Tomoko Noge
野毛 朋子=Tomoko Noge
野毛朋子=Tomoko Noge
朋子小姐=Tomoko-san
朋子=Tomoko
野毛=Noge
平井 亞蘭=Aran Hirai
平井亞蘭=Aran Hirai
平井=Hirai
亞蘭=Aran
池波=Ikenami

// CONFIDANTS //
梨本 成瑠海=Narumi Nashimoto
梨本成瑠海=Narumi Nashimoto
梨本=Nashimoto
成瑠海=Narumi
成瑠瑠=Naruru
李 瑤鈴=Yaoling Li
李瑤鈴=Yaoling Li
瑤鈴=Yaoling
藤川 雪實=Yukimi Fujikawa
藤川雪實=Yukimi Fujikawa
雪實小姐=Yukimi-san
雪實=Yukimi
藤川=Fujikawa
富山 佳代=Kayo Tomiyama
富山佳代=Kayo Tomiyama
富山=Tomiyama
佳代=Kayo
神山 嶺央=Reo Kamiyama
神山嶺央=Reo Kamiyama
神山=Kamiyama
嶺央=Reo
琴音 蒙塔涅·漫舞=Kotone Montagne
琴音 蒙塔涅=Kotone Montagne
琴音·蒙塔涅=Kotone Montagne
琴音前輩=Kotone-senpai
琴音小姐=Kotone-san
琴音姐=Kotone-san
琴音=Kotone
蒙塔涅=Montagne
黑江教練=Coach Kuroe
黑江=Kuroe
YUI=YUI
黑谷 清=Kiyoshi Kurotani
黑谷清=Kiyoshi Kurotani
黑谷=Kurotani
椎名 悠美=Yumi Shiina
椎名悠美=Yumi Shiina
椎名小姐=Shiina-san
椎名=Shiina
悠美小姐=Yumi-san
悠美=Yumi
坂井 綾香=Ayaka Sakai
坂井綾香=Ayaka Sakai
坂井=Sakai
綾香小姐=Ayaka-san
綾香=Ayaka
佐原 海夕=Miyu Sahara
佐原海夕=Miyu Sahara
佐原=Sahara
海夕=Miyu
北里 基良=Kira Kitazato
北里基良=Kira Kitazato
北里=Kitazato
基良=Kira
蘆谷 真咲=Masaki Ashiya
蘆谷真咲=Masaki Ashiya
蘆谷=Ashiya
真咲=Masaki
道玄坂 琉七=Runa Dogenzaka
道玄坂琉七=Runa Dogenzaka
道玄坂=Dogenzaka
琉七=Runa

// PALACE RULERS //
殘寶檢測儀·愛慾=<size\=21>Treasure Detector·Lust</size>
殘寶檢測儀·虛榮=<size\=21>Treasure Detector·Vanity</size>
殘寶檢測儀·憤怒=<size\=21>Treasure Detector·Wrath</size>
殘寶檢測儀·暴食=<size\=20>Treasure Detector·Gluttony</size>
愛慾=Lust
木內·邱比特·雄之=Takeyuki "Cupid" Kiuchi
木内 雄之=Takeyuki Kiuchi
木内雄之=Takeyuki Kiuchi
木内殿堂=Kiuchi's Palace
陰影木內=Shadow Kiuchi
陰影木内=Shadow Kiuchi
木内=Kiuchi
雄之=Takeyuki
虛榮=Vanity
宮澤·潘恩·博夢=Hiromu "Pan" Miyazawa
宮澤 博夢=Hiromu Miyazawa
宮澤博夢=Hiromu Miyazawa
宮澤殿堂=Miyazawa's Palace
陰影宮澤=Shadow Miyazawa
宮澤=Miyazawa
博夢=Hiromu
憤怒=Wrath
片山·基什基爾莉拉·久未=Kumi "Kiskil-lilla" Katayama
片山 久未=Kumi Katayama
片山久未=Kumi Katayama
片山老師=Katayama-sensei
片山殿堂=Katayama's Palace
陰影片山=Shadow Katayama
片山姐=Katayama-san
片山=Katayama
久未=Kumi
暴食者的終奏曲=Gluttony's Finale
暴食=Gluttony
明石 京=Kei Akashi
明石京=Kei Akashi
明石老師=Akashi-sensei
明石殿堂=Akashi's Palace
陰影明石=Shadow Akashi
明石大人=Akashi-sama
明石=Akashi

// CHARACTERS //
政哥=Masa-san
阿政=Masa
教務主任月見里=Head of Academics Yamanashi
教務主任=Head of Academics
月見里老師=Yamanashi-sensei
月見里=Yamanashi

// SIDE QUESTS //
西森陽菜=Haruna Nishimori
宮下美波=Minami Miyashita
長尾千津子=Chizuko Nagao
阿七=Shichi-kun
佐藤裕太=Yuta Sato
清水陸人=Rikuto Shimizu
小松奈美惠=Namie Komatsu
茶太=Chatai

// FUTURE //
白鳥誠司=Seiji Shiratori
須見俊也=Toshiya Sumi
小出日和=Hiyori Koide

// LOCATIONS //
澀谷=Shibuya
己刮學園=Kokatsu Academy
己刮=Kokatsu
軌雅高校=Kiga High School
軌雅=Kiga
壓勝軒=Asshouken
渡來軒=Toraiken

// METAVERSE //
殿堂=Palace
秘寶=Treasure
謝迪姆=Shedim

// PHRASES //
汪汪嚕=Woof Woof Ru

// ITEMS //
爆爆漢堡=Boom Bang Burger
扭蛋=Gachapon
水豚君=Capybara-kun
P代幣=P Coins

// TITLES //
前輩=Senpai
後輩=Kouhai
學姐=Senpai
老師=Sensei
