Locations
人格面具=Persona
天鵝絨房向=Velvet Room
安全屋=Safe Room
协同者=Confidant
异世界=Metaverse
印象空间=Mementos
卢布朗咖啡屋=Café Leblanc
卢布朗=Leblanc
生存游戏专卖店=Untouchable
武见诊所=Takemi Clinic
超市=Supermarket

Currencies
魂石=Soul Gems

Character Names
雨宫莲=Ren Amamiya
摩尔加纳=Morgana
坂本龙司=Ryuji Sakamoto
鸭志田=Kamoshida
高卷杏=Ann Takamaki
喜多川祐介=Yusuke Kitagawa
新岛真=Makoto Niijima
佐仓双叶=Futaba Sakura
奥村春=Haru Okumura
明智吾郎=Goro Akechi
李瑶铃=Yaoling Li
西森阳菜=Hina Nishimori
路菲尔=Ruferu
新井素羽=Motoha Arai
素羽=Motoha
新井=Arai
加纳骏=Shun Kanou
神山岭央=Reo Kamiyama
富山佳代=Tomiyama Kayo
野毛朋子=Tomoko Noge
黑谷清=Kiyoshi Kurotani
藤川雪实=Yukimi Fujikawa
白鸟诚司=Seiji Shiratori
须见俊也=Toshiya Sumi
琴音·蒙塔涅=Kotone Montagne
佐原海夕=Miyu Sahara
伊戈尔=Igor
梅洛普=Merope
木内雄之=Takeyuki Kiuchi
木内的=Kiuchi's
木内=Kiuchi
岩井宗久=Munehisa Iwai
阿七=Shichi-kun
池波学长=Ikenami-senpai
池波 星辉=Shoki Ikenami
池波星辉=Shoki Ikenami
星辉=Shoki
池波=Ikenami
平野 亚兰=Aran Hirano
平野亚兰=Aran Hirano
平野=Hirano
亚兰=Aran
下津名 高美=Takami Shimotsuna
下津名高美=Takami Shimotsuna
下津的陰影=Shimotsuna's Shadow
陰影下津=Shadow Shimotsuna
下津=Shimotsuna
名高美小姐=Takami-san
名高美=Takami
小骏=Shun
多祢村 理子=Riko Tanemura
多祢村理子=Riko Tanemura
多祢村学姐=Tanemura-senpai
多祢村同學=Tanemura-san
多祢村=Tanemura
理子学姐=Riko-senpai
理子前輩=Riko-senpai
理子小姐=Riko-san
理子=Riko
道玄坂 琉七=Runa Dogenzaka
道玄坂琉七=Runa Dogenzaka
道玄坂=Dogenzaka
琉七=Runa
芳泽霞=Kasumi Yoshizawa
琴音 蒙塔涅·漫舞=Kotone Montagne
{{A}}·未央使用=Riko Tanemura 
{{A}}·未央=Riko Tanemura
宫下美波=Minami Miyashita
北里基良=Kira Kitazato
{{A}}·太平乐使用={{A}}· New Year
芦谷真咲=Masaki Ashiya
桥本 麻由美=Mayumi Hashimoto
桥本麻由美=Mayumi Hashimoto
桥本=Hashimoto
麻由美=Mayumi
夏川 澪=Mio Natsukawa
夏川澪=Mio Natsukawa
夏川=Natsukawa

Persona Names 
亚森=Arsène
佐罗=Zorro
基德船长=Captain Kidd
卡门=Carmen
孟婆=Meng Po
戴埃拉=Daeira
罗布罗伊=Rob Roy
阿尔维达=Awilda
芒德兰=Mandrin
厄律忒亚=Erytheia
克丽奥多拉=Cleodora
普罗西姆纳=Prosymna
绪刻=Skye
斯堤克斯=Styx
琉科忒亚=Leucothea
戈尔究拉=Gorgyra
忒耳普西科瑞=Terpsichore
涅墨耳忒斯=Nemertes
亚诺希克=Jánošík
玄武=Genbu
比利士=Berith
克鲁波克鲁=Koropokguru
安德拉斯=Andras
莲南希=Leanan Sidhe
木叶天狗=Koppa Tengu
男梦魔=Incubus
希路奇=Silky
双角兽=Bicorn
凯尔派=Kelpie
幸魂=Saki Mitama
莫克伊=Mokoi
花魄=Hua Po
黑软泥怪=Black Ooze
软泥怪=Slime
埃力格=Eligor
杰克霜精=Jack Frost
母夜叉=Yaksini
奴延=Nue
飞天=Apsaras
木灵=Kodama
阴摩罗鬼=Onmoraki
一本踏鞴=Ippon-Datara
犬神=Inugami
奇魂=Kushi Mitama
真神=Makami
高等皮克希=High Pixie
狮爷=Shiisaa
欧若博司=Orobas
猫又=Nekomata
山灵=Sudama
朱雀=Suzaku
和魂=Nigi Mitama
大天使=Archangel
式王子=Shiki-Ouji
拉弥亚=Lamia
瑟坦特=Setanta
权天使=Principality
天钿女=Ame-no-Uzume
猫将军=Neko Shogun
欧特鲁斯=Orthrus
持国天王=Jikokuten
睡魔=Sandman
水鬼=Sui-Ki
罗刹=Rakshasa
那伽王=Raja Naga
那伽=Naga
佛劳洛斯=Flauros
伊西斯=Isis
阿努比斯=Anubis
独角兽=Unicorn
地狱天使=Hell Biker
苍白骑士=Pale Rider
白骑士=White Rider
莉莉姆=Lilim
拉刻西斯=Lachesis
荒霸吐=Arahabaki
贝尔芬格=Belphegor
阿特罗波斯=Atropos
诃梨帝母=Hariti
单卡拉比=Decarabia
密特拉=Mitra
菊理媛=Kikuri-Hime
大僧正=Daisoujou
大国主=Okuninushi
白虎=Byakko
那耳喀索斯=Narcissus
妙音天女=Sarasvati
欧赛=Ose
妖精女王=Queen Mab
广目天王=Koumokuten
荷鲁斯=Horus
红骑士=Red Rider
能天使=Power
虹蛇=Yurlungur
女武神=Valkyrie
斯卡哈=Scathach
兰达=Rangda
赛特=Seth
缇坦妮雅=Titania
巴风特=Baphomet
葛内舍=Ganesha
丝卡蒂=Skadi
帕尔瓦蒂=Parvati
摩洛=Moloch
迦楼罗=Garuda
八咫乌=Yatagarasu
托尔=Thor
八岐大蛇=Yamata-no-Orochi
贝利亚=Belial
主天使=Dominion
吉祥天女=Lakshmi
青龙=Seiryu
黄龙=Kohryu
爱丽丝=Alice
背背鬼=Obariyon
阿珈席翁=Agathion
曼陀罗=Mandrake
皮克希=Pixie
杰克灯笼=Jack-o'-Lantern
女梦魔=Succubus
天使=Angel
霜精之王=King Frost
风鬼=Fuu-Ki
斗牛士=Matador
克洛托=Clotho
凤凰=Phoenix
金鬼=Kin-Ki
安祖=Anzu
增长天王=Zouchouten
荒魂=Ara Mitama
佳塔由=Jatayu
天蛾人=Mothman
托特=Thoth
迦温=Kaiwan
米特拉斯=Mithras
百臂巨人=Hecatoncheires
基力梅卡拉=Girimehkala
鸠盘荼=Kumbhanda
奇稻田姬=Kushinada-Hime
帕祖祖=Pazuzu
巴古斯=Bugs
荼吉尼=Dakini
巴隆=Barong
斯尔特=Surt
克鲁贝洛斯=Cerberus
黑骑士=Black Rider
羽蛇神=Quetzalcoatl
狄俄尼索斯=Dionysus
奈比洛斯=Nebiros
奥伯隆=Oberon

套装效果=Kit effect
防御力=DEF
攻击力=ATK
生命值=HP
精力值=SP
速度=SPD
暴击率=Critical Rate
暴击效果=Critical Damage
精力回复=SP Regen
战斗技巧=Combat Skills
玛哈拉基翁=Maragion
玛哈拉基=Maragi
亚基达因=Agidyne
亚基拉欧=Agilao
亚基=Agi
玛哈布芙拉=Mabufula
玛哈布芙=Mabufu
布芙拉=Bufula
布芙=Bufu
玛哈吉欧加=Mazionga
吉欧加=Zionga
玛哈吉欧=Mazio
吉欧=Zio
玛哈加尔=Magaru
加尔=Garu
玛哈芙雷拉=Mafreila
玛哈芙雷=Mafrei
芙雷拉=Freila
芙雷=Frei
念动破坏=Psy Destruction
玛哈赛=Mapsi
玛哈克加=Makouha
克加=Kouga
克哈=Kouha
哈玛=Hama
玛哈耶哈=Maeiha
耶加=Eiga
耶哈=Eiha
玛哈姆多=Mamudo
姆多=Mudo
米吉多拉=Megidola
吸血=Life Drain
吸魔=Spirit Drain
梅迪亚拉翰=Mediarahan
迪亚拉翰=Diarahan
梅迪拉玛=Mediarama
梅迪亚=Media
迪亚拉玛=Diarama
迪亚=Dia
帕特拉=Patra
马哈塔尔卡加=Matarukaja
塔尔卡加=Tarukaja
自动玛哈拉库卡=Auto-Maraku
马哈拉库卡加=Marakukaja
拉库卡加=Rakukaja
斯库卡加=Sukukaja
塔伦达=Tarunda
拉昆达=Rakunda
俯冲突击=Assault Dive
头槌=Headbutt
幸运拳=Lucky Punch
歇斯底里掌掴=Hysterical Slap
猛烈巨锤=Sledgehammer
电光石火=Tempest Slash
大切断=Giant Slice
横冲直撞=Rampage
梦乡针=Dream Needle
碎脑击=Brain Shake
指弹=Snap
永眠=Dormina
晕眩针=Dazzler
消除火炎耐性=Fire Break
防电之壁=Elec Wall
睡眠耐性=Resist Sleep
遗忘耐性=Resist Forget
晕眩耐性=Resist Dizzy
气功=Invigorate
杂司谷=Zoshigaya
的楼梯=staircases
地铁站=Subway Station
电话亭=Telephone booths
旺盛童心=Innocent Spirit
聪明的探险家=Wise Explorer
笨笨的助手=Clumsy Mind
顽狮闹=Mischievous Lion
彼岸之丛=From the Other Side
摆渡者=Ferryman
无影直刺=Shadowless Stab
优雅暴风=Elegant Storm
风之呼啸=Howling Wind
绝地反击=Counterstrike
黑白无界=Blurred Lines
子弹时间=Bullet Time
爆炎=Explosive Flame
火焰净化=Purifying Fire
烛火焚心=Candle's Sorrow
寒冰之刃=Frigid Blade
凛冬撕裂=Arctic Tear
冰之绽放=Frost Bloom
疾风强袭=Swift Storm
疗愈之术=Healing Cure
繁花热烈=Fiery Bloom
魅火术=Enchanting Fire
火炎侵蚀=Flame Corrosion
念之旋律=Mental Melody
叶笛赞歌=Ode of the Leaf Flute
晚安曲=Lullaby
雷霆之怒=Wrath of Thunder
超速电击=Lightning Strike
电鸣狂鲨=Shark Shock
雀跃火枭=Flaming Owl
天使的怜悯=Divine Healing
希望光束=Ray of Hope
蓄力一击=Charged Strike
电击惩戒=Voltage Vengeance
爆裂撞击=Raging Impact
无畏压制=Fearless Subjugation
不祥的预兆=Ominous Sign
厄运追击=Chase of Doom
派对狂欢=Party Craze
华丽摇摆=Elegant Sway
热辣变奏曲=Fierce Remix
无忧之歌=Carefree Melody
黎明的泡沫=Foam of Dawn
交汇之舞=Converging Minds
叠层=Stacks
燃烧=Burn
单伤=Single-Target
群伤=Multi-Target
绝对审判=Absolute Judgement
正理之令=Decree of Righteousness
大义者裁决=Rules of the Righteous
怪盗团=Phantom Thieves
怪盗培养=Velvet Room
向日葵=Sunflower


玛奇姆=Marthym
安德森=Anderson
二连牙=Double Fang
反叛=Rebellion
怒火加持=Taunt
枪械识破=Resist Gun
物理识破=Resist Phys
治疗促进=Regenerate
表参道=Omotesando
西参道=Nishisendo
地下商场=Underground Mall
联络桥=Skyway
中央大街=Central Street
十字路口=Intersection
站前广场=Station Square
学校正门=School Entrance
下北泽车站=Shimokitazawa Station
学校天台=School Rooftop
学校三楼=School 3rd Floor
学校二楼=School 2nd Floor
学校一楼=School 1st Floor
四轩茶屋=Yongen-Jaya
空空如也=Empty
二手杂货店=Occasion Store
扭蛋=Gachapon
衣柜=Wardrobe
工作台=Workshop
种植=Garden
烹饪=Kitchen
展示柜=Display case
卧室=Bedrooms
是否要=Do you want to 
荻洼=Ogikubo
原宿=Harajuku
神保町=Jimbōchō
水道桥=Suidōbashi
神田=Kanda
免费=Free
